******************
*-------**-------*
*-------**-------*
*-------**-------*
*-------><-------*
*-------**-------*
*-------**-------*
*-------**-------*
*v*************v**
*^*************^**
*-------**-------*
*-------**-------*
*-------**-------*
*-------><-------*
*-------**-------*
*-------**-------*
*-------**-------*
******************